day	日	
person	人	
one	一	
see	見	目儿丿㇟
goods	品	口
matter	事	口⺕亅
large	大	人
fit	合	𠆢一口
book	本	木丨
enter	入	
exit	出	山丨凵
direction	方	亠
going	行	彳亻
in	中	口丨
utilize	用	
spirit	気	气𠂉乂丿
part	分	八刀
meeting	会	𠆢云二一厶
time	時	日寺土寸
above	上	卜一
report	報	幸土𢆉䒑干十卩又
location	場	土昜旦日一勿勹
now	今	𠆢一
interval	間	門日
feelings	情	忄青龶月
life	生	
think	思	田心
new	新	立亠木斤
make a deal	商	立亠冏冂儿丿㇟口
scribe	記	言口己
utmost	最	日取耳又
fee	料	米木斗丶
year	年	丿干十
oneself	自	目
make	作	亻乍丿
someone	者	耂土日
inside	内	冂丨人
determine	定	宀冖疋龰卜人
surface	表	二一丨衣亠𧘇
hand	手	
in front	前	八月刂
ground	地	土也乙
child	子	了㇇亅一
question	問	門口
escort/send off	送	天大人⻌
write	書	聿⺕丨日
business/profession	業	业丶羊⺷䒑木
below	下	一卜
discharge	発	癶二一儿丿㇟
thing	物	牛勿勹
country	国	囗玉王丶
show	示	二一小
nothingness	無	丿一灬
move	動	重千丿十里力
say	言	口
bull's eye	的	白日勺勹丿丶
store	店	广厂占卜口
logic	理	王里日
company	社	礻土
music	楽	白日冫木
study	学	⺍冖子了㇇亅一
eye	目	
use	使	亻吏丈一口乂丿
hit	当	⺌⺕
behind	後	彳亻幺夂
connection	関	門关天大人
examination	検	木㑒人一口
-times	回	囗口
whole	全	𠆢王人
traffic	通	甬マ㇇用⻌
by means of	以	丶人
profit	利	禾丿木刂
sentence	文	亠乂
come	来	米木丿
section	部	咅立亠口⻏
emotion	感	咸戍厂戈弋一口丿丶心
brush stroke	画	一由田丨凵
reality	実	宀冖𡗗三二一人
take	取	耳又
private	私	禾丿木厶
power	力	
open	開	門开干十
vis-a-vis	対	文亠乂寸
add	加	力口
name	名	夕口
tall	高	亠口冂
tale	話	言口舌千
degrees	度	广厂廿十又
near	近	斤⻌
method	法	氵去土厶
month	月	
Esq.	様	木羊⺷䒑氺
eat	食	𠆢艮
gold	金	全𠆢王
know	知	矢天大人口
crowded	込	入⻌
body	体	亻本木
cord	索	十冖糸幺小
elect	選	巽己共龷八⻌
turn into	成	𠂊丿戈弋丶
house	家	宀冖豕
idea	意	音立亠日心
value	価	亻覀
ascend	登	癶豆一口䒑
number	数	娄米木女攵乂丿
what	何	亻可丁一口亅
record	録	金全𠆢王彔⺕氺
ability	能	厶月匕
unusual	変	亦亠丿亅夂
sex	性	忄生
heart	心	
adhere	付	亻寸
need	要	覀女
place	所	戸斤
other	他	亻也乙
perusal	覧	臣𠂉見目儿丿㇟
before	先	儿丿㇟
true	真	十具目八
affair	件	亻牛
flavor	味	口未木
same	同	冂一口
market	市	亠巾
faith	信	亻言口
mechanism	機	木幾幺戍戈弋厂人一丿丶
outside	外	夕卜
buy	買	罒貝目八
sell	売	士冖儿丿㇟
long	長	
assurance	確	石口寉宀冖隹亻
bright	明	日月
gather	集	隹亻木
negative	不	一丿丨
little	小	
pour	注	氵主丶王
consider	考	耂土丂丿
present	現	王見目儿丿㇟
take along	連	車日⻌
many	多	夕
stand up	立	亠
good	良	艮
substitute	代	亻弋丶
hold	持	扌寺土寸
status	格	木各夂口
grope	探	扌㓁冖儿丿㇟木
relax	安	宀冖女
tie	結	糸幺小吉士口
promise	約	糸幺小勺勹丿丶
car	車	日
exist	在	亻土
change	化	亻匕
acknowledge	認	言口忍刃刀丶心
special	特	牛寺土寸
protect	保	亻呆口木
establishment	設	言口殳几丿又
heavens	天	一大人
lively	活	氵舌千口
fond	好	女子了㇇亅一
employee	員	口貝目八
period	期	其甘廿十八月
throw	投	扌殳几丿又
beforehand	予	マ㇇了亅
etc.	等	竹寺土寸
read	読	言口売士冖儿丿㇟
load	載	𢦏土十戈弋車日丿丶
teach	教	孝耂土子了㇇亅一攵乂丿
electricity	電	雨日
mountain	山	
copy	写	冖与一
can	可	丁一口亅
mask	面	而
turn	番	釆丿米木田
first time	初	衤刀
woman	女	
cut	切	七一刀
distribute	配	酉西一囗儿丿㇟己
nonplussed/visit	参	厶大人彡
invariably	必	心丶丿
water	水	
road-way	道	首自目⻌
pull	引	弓丨
roof	屋	尸至土
attend	仕	亻士
products	産	立亠厂生
detailed	詳	言口羊⺷䒑
grow late	更	一日乂丿
rice field	田	
accept	受	⺤冖又
No.	第	竹弔弓丨丿
sutra	経	糸幺小圣又土
substance	質	斤貝目八
beauty	美	⺷䒑大人
next	次	冫欠人
word	語	言口吾五二一
generation	世	廿十一丨
fruit	果	日木丨
few	少	小丿
possess	有	月
continue	続	糸幺小売士冖儿丿㇟
topic	題	是日疋龰卜人頁貝目八
don	着	羊⺷䒑丿目
unravel	解	角𠂊刀牛
chase	追	𠂤丿⻌
put up (a notice)	掲	扌曷日匂勹丿人匕
apply	応	广厂心
separate	別	口勹丿刂
inter-	相	木目
decide	決	氵夬大人
east	東	木日丿
yonder	向	丿冂丨口
usual	常	尚⺌冂吊口巾
contain	容	宀冖谷𠆢口
sea	海	氵毎丿毋
accomplished	達	土羊⺷䒑⻌
circle	円	冂
standard	規	夫大人見目儿丿㇟
plains	野	里日予了㇇亅
jammed in	介	𠆢丿丨
war	戦	単⺍甲日一丨戈弋丿丶
spot	点	占卜口灬
public	公	八厶
correct	正	一止卜
finger	指	扌旨匕日
map	図	囗⺍乂丿
lord	主	亠丶王
dainty	細	糸幺小田
association	組	糸幺小且月一
status quo	状	⺦犬大人丶
laugh	笑	竹夭丿大人
color	色	𠂊巴己
wind	風	几丿虫中口丨
tune	調	言口周冂吉士
wide	広	广厂厶
difference	違	韋口⻌
strong	強	弓厶虫中口丨
dwell	住	亻主丶王
world	界	田介𠆢丿丨
style	式	弋工丶
elementary	素	龶三二一糸幺小
gain	得	彳亻旦日一寸
love	愛	⺤冖心夂
statue	像	亻象𠂊豕
individual	個	亻固囗古十口
simple	単	⺍丶甲日十一丨
beginning	元	二一儿丿㇟
prefecture	県	目小
return	返	反厂又⻌
plot	計	言口十
petition	願	原厂丿泉白日小頁貝目八
guest	客	宀冖各夂口
sound	音	立亠日
bring up	育	亠厶月
assets	資	次冫欠人貝目八
end	終	糸幺小冬夂冫
carry	運	軍冖車日⻌
submit	供	亻共龷八
hear	聞	門耳
twig	条	夂木
empty	空	穴宀冖八工
trip	旅	方亠𠂉亻
meadow	原	厂泉白日小
occasion	際	⻖祭月示二一小
task	務	矛予マ㇇了亅丿攵乂力
re-	戻	戸大人
marketing	販	貝目八反厂又
evaluate	評	言口平干十
somebody	身	
species	種	禾丿木重千十里
branch	支	十又
heavy	重	千丿十里
stream	川	
two	二	一
revelation	告	牛口
overdo	過	咼冂口⻌
verification	験	馬灬㑒人一口
capital	京	亠口小
introduce	紹	糸幺小召刀口
subscription	購	貝目八冓三二一再冉冂土
three	三	二一
revolve	転	車日云二一厶
current	流	氵㐬亠厶川
rumor	説	言口兌八兄儿丿㇟
obey	順	川頁貝目八
fundamentals	基	其甘廿十八土
occupation	営	⺍冖呂口丿
sort of thing	然	月犬大人丶灬
straightaway	直	十目
mouth	口	
draft	稿	禾丿木高亠口冂
friend	友	又
commence	始	女台厶口
concept	想	相木目心
lumber	材	木才扌亅
limit	限	⻖艮
gods	神	礻申日丨
exam	校	木交亠父
deliver	届	尸由日丨
white	白	日
metropolis	都	者耂土日⻏
pipe	管	竹官宀冖口
flower	花	艹化亻匕
line	線	糸幺小泉白日水
people	民	氏一
week	週	周冂吉士口⻌
wait	待	彳亻寺土寸
old	古	十口
system	制	牛巾刂
sash	帯	丗卅廾廿十川丿冖巾
exclude	除	⻖余𠆢小
island	島	鳥丿山
warehouse	庫	广厂車日
reflect	映	日央大人
harmony	和	禾丿木口
choose	択	扌尺尸八
fall	落	艹洛氵各夂口
outlook	観	𠂉隹亻見目儿丿㇟
solution	答	竹合𠆢一口
include	含	今𠆢一口
even	平	干一十
placement	置	罒直十目
alms	施	方亠𠂉也乙
leg	足	口龰
art	術	行彳亻朮木丶
plan	案	安宀冖女木
mingle	交	亠父
craft	工	
request	求	氺丶
head	頭	豆一口䒑頁貝目八
nickname	号	口一
post	職	耳戠音立亠戈弋日丿丶
each	各	夂口
homecoming	帰	刂帚⺕冖巾
propose	提	扌是日疋龰卜人
finish	済	氵斉文亠乂二一
duty	役	彳亻殳几丿又
advance	進	隹亻⻌
agriculture	農	曲日廾丿十辰厂
tree	木	
made in...	製	制牛巾刂衣亠𧘇
north	北	匕
remainder	残	歹一夕戋三二戈弋丿丶
sort	類	米木大人頁貝目八
leaf	葉	艹枼世廿十一木
early	早	日十
town	村	木寸
victory	勝	月劵二一人力
ten thousand	万	一
walk	歩	止卜少小丿
complete	了	㇇亅
test	試	言口式弋工丶
printing block	版	片反厂又
un-	非	
range	域	土或戈弋口一丿丶
lengthen	張	弓長
posture	構	木冓三二一再冉冂土
equip	備	亻艹厂用
rank	位	亻立亠
station	駅	馬灬尺尸八
ride	乗	千丿十木
elephant	象	𠂊豕
shape	形	开干十彡
rest	休	亻木
village	町	田丁一亅
undertake	企	𠆢止卜
morning	朝	𠦝十早日月
every	毎	𠂉丿毋
polish	研	石口开干十
transmit	伝	亻云二一厶
skill	技	扌支十又
deliberation	議	言口義羊⺷䒑我丿戈弋亅丶
male	男	田力
simplicity	簡	竹間門日
merit	効	交亠父力
ambition	望	亡亠匸月王
speaketh	申	日丨
half	半	丶二一十
income	収	丨又
stop	止	卜
character	字	宀冖子了㇇亅一
summer	夏	一自目夂
circumference	周	冂吉士口
pedestal	台	厶口
bad	悪	亜二一口心
reach out	及	丿又
ray	光	⺌兀一儿丿㇟
together	共	龷八
compare	比	匕
full	満	氵艹十両冂山
politics	政	正止卜攵乂丿
ten	十	
convenience	便	亻更日乂丿
portable	携	扌隽隹亻乃丿
wherefore	由	日丨
suitable	適	啇亠冂古十口⻌
pay	払	扌厶
place on the head	頂	丁一亅頁貝目八
Inst.	院	⻖完宀冖元二一儿丿㇟
soil	土	
stocks	株	木朱未
severance	断	米木斤
interchange	換	扌奐𠂊冂儿丿㇟大人
Bldg.	館	飠官宀冖口
he	彼	彳亻皮又
night	夜	亠亻夕
person in charge	係	亻系丿糸幺小
home	宅	宀冖乇丿七一
performance	演	氵寅宀冖由日丨八
general	総	糸幺小忩公八厶心
bend	曲	日廾丨
tenderness	優	亻憂百日冖心夂
extinguish	消	氵肖⺌月
again	再	一冉冂土
department	科	禾丿木斗丶
set free	放	方亠攵乂丿
plank	板	木反厂又
renowned	著	艹者耂土日
price	値	亻直十目
mould	型	刑开干十刂土
paragraph	項	工頁貝目八
compilation	編	糸幺小扁戸冊冂廾十丿
learn	習	羽白日
suppose	存	亻子了㇇亅一
authority	権	木𠂉隹亻
gates	門	
specialty	専	由日丨寸
reign	治	氵台厶口
example	例	亻列歹一夕刂
park	園	囗袁土衣亠𧘇口
room	室	宀冖至土
rouse	起	走土龰己
ill	病	疒丙一内冂人
reformation	改	己攵乂丿
anti-	反	厂又
utensil	器	口大人
inn	宿	宀冖佰亻百白日
doctor	医	匸矢天大人
investigate	査	木且月一
evidence	証	言口正止卜
drink	飲	飠欠人
warm	温	氵日皿
quantity	量	旦日一里
bake	焼	火人尭卉十廾丿兀一儿㇟
yesterday	昨	日乍丿
healthy	健	亻建聿⺕丨廴
research	究	穴宀冖八九乙
attitude	態	能厶月匕心
environs	辺	刀⻌
acquiesce	承	了㇇亅手三二一水丿
strangle	絞	糸幺小交亠父
all	皆	比匕白日
lineage	系	丿糸幺小
voice	声	士
safeguard	護	言口蒦艹隻隹亻又
west	西	一囗儿丿㇟
ward	区	匸乂丿
judgment	判	半二一十刂
stone	石	口
parent	親	立亠木見目儿丿㇟
discriminating	識	言口戠音立亠戈弋日丿丶
build	建	聿⺕丨廴
grade	段	殳几丿又
tool	具	目八
universal	普	並八一业日
doth	致	至厶土攵乂丿
expense	費	弗弓丿丨貝目八
song	歌	哥可丁一口亅欠人
quick	速	束木口⻌
face	顔	彦立亠厂彡頁貝目八
gentleman	士	
shake	振	扌辰厂
squat/sit	座	广厂坐从人土
shift	移	禾丿木多夕
but of course	況	氵兄口儿丿㇟
touch	接	扌妾立亠女
discuss	談	言口炎火人
defeat	負	𠂊貝目八
lightly	軽	車日圣又土
abet	援	扌爰⺤友又
uncommon	異	田共龷八
perfect	完	宀冖元二一儿丿㇟
argument	論	言口侖人一冊冂廾十丿
horse	馬	灬
boundary	境	土竟立亠音日儿丿㇟
increase	増	土曽田日
extent	程	禾丿木呈口王
difficult	難	艹口夫大人隹亻
long time	久	𠂊丿
heal	療	疒尞大人日小
create	造	告牛口⻌
harm	害	宀冖龶口
organize	整	敕束木口攵乂丿正止卜
exchange	替	夫大人日
ring	環	王睘罒口𧘇
wish	念	今𠆢一心
blessing	福	礻畐一口田
England	英	艹央大人
discipline	修	攸亻丨攵乂丿彡
gone	去	土厶
group	団	囗寸
plump	太	大人丶
unfold	展	尸廾十丿
descend	降	⻖夅夂㐄
memorize	覚	⺍冖見目儿丿㇟
proportion	割	害宀冖龶口刂
miscellaneous	雑	九乙木隹亻
death	死	歹一夕匕
scheme	策	竹朿木冂
recruit	募	莫艹日大人力
play	遊	斿方亠𠂉子了㇇亅一⻌
rice	米	木
path	路	足口各夂
responsibility	任	亻壬丿士
semi-	準	氵隼隹亻十
husband	夫	大人丿
draw near	寄	宀冖奇大人可丁一口亅
attire	装	壮⺦士衣亠𧘇
honorable	御	彳亻卸午干正十止卜卩
tax	税	禾丿木兌八兄口儿㇟
forehead	額	客宀冖各夂口頁貝目八
co-	協	十劦力
hurry	急	𠂊⺕心
signpost	標	木票覀示二一小
bureau	局	尸句勹丿口
shadow	影	景日京亠口小彡
red	赤	亦土
tag	札	木乙
ease/sane	康	广厂隶⺕氺
sake	酒	氵酉西一囗儿丿㇟
wealth	富	宀冖畐一口田
not yet	未	木丿
do	為	丶勹丿灬
precipitous	険	⻖㑒人一口
longing	欲	谷𠆢口欠人
ball	球	王求氺丶
entwine	絡	糸幺小各夂口
ward off	防	⻖方亠
help	助	且月一力
door	戸	
well	井	二一廾十丿
bountiful	豊	曲日廾丿十豆一口䒑
shouldering	担	扌旦日一
snapshot	撮	扌最日取耳又
tea	茶	艹人木
family name	氏	
who?	誰	言口隹亻
inspection	視	礻見目儿丿㇟
spring	泉	白日水
expert	師	丿丨巾
dispose	処	夂几丿
contrast	較	車日交亠父
lose	失	丿夫大人
fly	飛	升十廾丿
incense	香	禾丿木日
run	走	土龰
mama	母	毋
righteousness	義	羊⺷䒑我丿戈弋亅丶
surpass	越	走土龰戉厂戈弋丿丶
settlement	納	糸幺小内冂人
about that time	頃	匕頁貝目八
picture	絵	糸幺小会𠆢云二一厶
fate	命	人一口卩
south	南	䒑十冂干
old boy	君	尹⺕尸丿口
hope	希	乂丿布巾
discontinue	絶	糸幺小色𠂊巴己
forget	忘	亡亠匸心
Mount	岡	冂䒑山
tribe	族	方亠𠂉矢天大人
plane	削	肖⺌月刂
handle	扱	扌及丿又
extremity	末	木丿
strike	打	扌丁一亅
detach	離	离亠凶乂丿凵禸厶冂隹亻
thong	緒	糸幺小者耂土日
calculate	算	竹目廾十丿
transcend	超	走土龰召刀口
reside	居	尸古十口
surround	囲	囗井二一廾十丿
rain	雨	
lie down	寝	宀冖⺦⺕又
me	僕	亻菐业三二一人
heat	熱	埶土儿丿㇟丸九乙丶灬
weekday	曜	日羽隹亻
route	途	余𠆢小⻌
fire	火	人
class	級	糸幺小及丿又
lecture	講	言口冓三二一再冉冂土
Shinto shrine	宮	宀冖呂口丿
blue	青	龶月
push	押	扌甲日丨
black	黒	里日灬
silver	銀	金全𠆢王艮
side	側	亻則貝目八刂
lower	低	亻氏一
swamp	沢	氵尺尸八
distinction	差	羊⺷䒑丿工
happiness	幸	土𢆉䒑干十
shop	舗	人吉士口甫用丶
year-end	歳	止卜戌厂戈弋一小丿丶
row	並	八一业
medicine	薬	艹楽白日冫木
lend	貸	代亻弋丶貝目八
sideways	横	木黄龷由八
salary	給	糸幺小合𠆢一口
pine tree	松	木公八厶
guidance	導	道首自目⻌寸
suffering	苦	艹古十口
curriculum	歴	厂林木止卜
slip out	抜	扌友又
young	若	艹右口
overnight	泊	氵白日
thousand	千	丿十
king	王	
wisteria	藤	艹滕月劵二一人氺
four	四	囗儿丿㇟
faction	派	氵𠂢丿亻
work	働	亻動重千丿十里力
fabricate	築	筑竹工凡几丿丶木
Heights	阪	⻖反厂又
meat	肉	冂人
ratio	率	玄亠幺冫十
stamp	印	丿丨卩
volume	積	禾丿木責龶貝目八
fare	賃	任亻壬丿士貝目八
valley	谷	𠆢口
ego	我	丿戈弋亅丶
single	独	⺨虫中口丨
becoming/similar	似	亻以丶人
trust	頼	束木口頁貝目八
carrier	般	舟殳几丿又
son	郎	良艮⻏
entertain	興	𦥑同冂一口八
dwindle	減	氵咸戍厂戈弋一口丿丶
listen	聴	耳十罒心
deep	深	氵㓁冖儿丿㇟木
myself	俺	亻奄大人电日
translate	訳	言口尺尸八
root	根	木艮
paper	紙	糸幺小氏
call	呼	口乎丿亅
restore	復	彳亻复𠂉日夂
blame	責	龶貝目八
supplement	補	衤甫用丶
poles	極	木亟二一口又
history	史	口乂丿丨
baggage	荷	艹何亻可丁一口亅
enroll	籍	竹耒丿未木昔龷日廾十
permit	許	言口午干十
dream	夢	艹罒冖夕
scenery	景	日京亠口小
belong	属	尸禹丿虫禸厶冂
pain	痛	疒甬マ㇇用
distant	遠	袁土衣亠𧘇口⻌
ballot	票	覀示二一小
newborn babe	児	旧丨日儿丿㇟
cheerful	快	忄夬大人
node	節	竹即艮卩厶
romance	恋	亦亠丿亅心
stubborn	頑	元二一儿丿㇟頁貝目八
prize	賞	尚⺌冂口貝目八
iron	鉄	金全𠆢王失丿夫大人
solicit	請	言口青龶月
both	両	一冂山
linen	布	巾
springtime	春	𡗗三二一大人日
prohibition	禁	林木示二一小
slow	遅	尸羊⺷䒑⻌
angle	角	𠂊
promontory	崎	山奇大人可丁一口亅
marriage	婚	女昏氏日
cool	冷	冫令𠆢一マ㇇
guard	守	宀冖寸
broaden	拡	扌広广厂厶
boulevard	街	行彳亻圭土
violent	激	氵敫白日放方亠攵乂丿
star	星	日生
sponsor	催	亻崔山隹
bestow	与	一
livelihood	暮	莫艹日大人
borough/municipality	府	广厂付亻寸
practice	練	糸幺小東木日
witch	魔	麻广厂林木鬼丿田儿㇟厶
overall	統	糸幺小充亠允厶儿丿㇟八
forest	森	木林
beat	撃	車日殳几丿又手
right	右	口
wash	洗	氵先儿丿㇟
left	左	工
labor	労	⺍冖力
happenstance	故	古十口攵乂丿
committee	委	禾丿木女
ocean	洋	氵羊⺷䒑
sheet of...	枚	木攵乂丿
bridge	橋	木喬呑夭丿大人口冂
fur	毛	
enemy	敵	啇亠冂古十口攵乂丿
refined	精	米木青龶月
stab	突	穴宀冖八大人
scroll	巻	𠔉二一大人己
five	五	二一
ticket	券	𠔉二一大人刀
dog	犬	大人丶
junior	徒	彳亻走土龰
castle	城	土成𠂊丿戈弋丶
source	源	氵原厂泉白日小
go-between	仲	亻中口丨
duplicate	複	衤复𠂉日夂
clothing	服	月卩又
focus	省	少小丿目
badge	章	音立亠早日十
father	父	
boom	盛	成𠂊丿戈弋丶皿
jewel	玉	王丶
noon	午	丿干十
pick	採	扌采⺤木
scatter	散	月攵乂丿
forces	勢	埶土儿丿㇟丸九乙丶力
echo	響	郷乡艮⻏音立亠日
technique	芸	艹云二一厶
hinder	障	⻖章立亠早日十
hang	掛	扌卦圭土卜
storey	階	⻖皆比匕白日
waves	波	氵皮又
closed	閉	門才扌亅
transit	渡	氵度广厂廿十又
seacoast	浜	氵兵丘斤一八
symptoms	症	疒正止卜
courtyard	庭	广厂廷壬丿士廴
eight	八	
allot	充	亠允厶儿丿㇟八
ritual	祭	月示二一小
detain	留	卯卩丿田
vegetable	菜	艹采⺤木
appellation	称	禾丿木尓小
dislike	嫌	女兼䒑八⺕丨
abbreviation	略	田各夂口
exhausted/tired	疲	疒皮又
edge	端	立亠耑山而冂
document	誌	言口志士心
code	典	曲日廾丿十八
autumn	秋	禾丿木火人
illuminate	照	昭日召刀口灬
tooth	歯	止卜米木凵
round	丸	九丿乙丶
warrior	武	一弋止卜丶
sketch	描	扌苗艹田
vie	競	立亠兄口儿丿㇟
short	短	矢天大人豆一口䒑
call on	訪	言口方亠
kill	殺	乂丿木殳几又
back	裏	衣亠𧘇里日
dispatch	遣	中口丨⻌
aggression	攻	工攵乂丿
seasons	季	禾丿木子了㇇亅一
seat	席	广厂廿十巾
evening	夕	
conjecture	推	扌隹亻
clear up	晴	日青龶月
virtuous	善	羊⺷䒑八口
diligence	勤	菫艹三二一力
cat	猫	⺨苗艹田
splendor	華	艹丨
notebook	帳	巾長
chapter	課	言口果日木
figure	姿	次冫欠人女
failure	敗	貝目八攵乂丿
state	州	丶川丨
trouble	悩	忄⺍凶乂丿凵
secret	秘	禾丿木必心
daytime	昼	尺尸八旦日一
blood	血	皿
breath	息	自目心
dance	舞	丿一舛夕
welcome	迎	卬卩⻌
good luck	吉	士口
weave	織	糸幺小戠音立亠戈弋日丿丶
imitation	模	木莫艹日大人
grass	草	艹早日十
beans	豆	一口䒑
quandary	困	囗木
double	倍	亻咅立亠口
foster	養	羊⺷䒑食𠆢艮
meal	飯	飠反厂又
secrecy	密	宓宀冖必心丿山
exertion	勉	免𠂊儿丿㇟力
too much	余	𠆢小
Korea	韓	𠦝十早日韋口
check-up	診	言口人彡
sack	袋	代亻弋丶衣亠𧘇
hot water	湯	氵昜旦日一勿勹
valve	弁	厶廾十丿
excuse	免	𠂊儿丿㇟
assistant	佐	亻左工
impart	授	扌受⺤冖又
rejoice	喜	吉士口
fish	魚	𠂊田灬
property	財	貝目八才扌亅
neck	首	自目
quiet	静	青龶月争𠂊⺕亅
rend	破	石口皮又
outline	概	木既艮旡儿丿㇟八
or again	又	
plant	植	木直十目
cause	因	囗大人
bird	鳥	灬
oversee	監	臣𠂉皿
harbor	港	氵巷共龷八己
retreat	退	艮⻌
texture	肌	月几丿
open sea	沖	氵中口丨
army	軍	冖車日
overthrow	倒	亻到至厶土刂
hundred	百	一白日
creek	江	氵工
dissolve	融	鬲一口冂儿丿㇟虫中丨
raise	挙	⺍八手
storehouse	蔵	艹厂戈弋臣丿丶
grove	林	木
lady	婦	女帚⺕冖巾
oil	油	氵由日丨
salute/salutation	礼	礻乙
director	司	一口
muscle	筋	竹肋月力
genesis	創	倉人口刂
Buddhist temple	寺	土寸
accompany	従	彳亻疋龰卜人
chastise	討	言口寸
contend	争	𠂊丿⺕亅
tray	盤	般舟殳几丿又皿
once upon a time	昔	龷日廾十丿
fresh	鮮	魚𠂊田灬羊⺷䒑
sweet	甘	廿十
earnings	稼	禾丿木家宀冖豕
guess	察	宀冖祭月示二一小
rule	則	貝目八刂
just so	是	日疋龰卜人
pressure	圧	厂土
achievement	功	工力
street	丁	一亅
maneuver	操	扌喿品口木
inherit	継	糸幺小米木
precious	貴	中口丨貝目八
inverted	逆	屰屮凵丿⻌
public chamber	堂	尚⺌冂口土
bomb	爆	火人暴日㳟共龷八氺
fold	折	扌斤
sleep	眠	目民氏
length	丈	一乂丿
astray	迷	米木⻌
transport	輸	車日兪入一月刂
Nara	奈	大人示二一小
nine	九	丿乙
arrival	到	至厶土刂
party	党	尚⺌冂兄口儿丿㇟
gist	趣	走土龰取耳又
celebrate	祝	礻兄口儿丿㇟
incur	被	衤皮又
damage	損	扌員口貝目八
fortune-telling	占	卜口
mutually	互	二一彑
freight	貨	化亻匕貝目八
stature	背	北匕月
mix	混	氵昆日比匕
ship	船	舟㕣八口
old man	老	耂土匕
harden	固	囗古十口
pond	池	氵也乙
above-stated	該	言口亥亠人
favor	恵	由日丨心
angling	釣	金全𠆢王勺勹丿丶
pure	清	氵青龶月
doubt	疑	匕矢天大人マ㇇疋卜
snow	雪	雨⺕
apologize	謝	言口射身寸
stern	厳	⺍厂敢耳攵乂丿
chronicle	紀	糸幺小己
straw rope	縄	糸幺小电日
design	柄	木丙一内冂人
fathom	測	氵則貝目八刂
haven	津	氵聿⺕丨
rhythm	律	彳亻聿⺕丨
abdomen	腹	月复𠂉日夂
nativity	誕	言口延正丿止卜廴
hanging scroll	幅	巾畐一口田
cry	泣	氵立亠
file	列	歹一夕刂
halt	停	亻亭亠口冖丁一亅
fight	闘	門豆一口䒑寸
plum	梅	木毎丿毋
bathe	浴	氵谷𠆢口
regiment	隊	⻖豕
fear	恐	工凡几丿丶心
sunshine	陽	⻖昜旦日一勿勹
intention	志	士心
concerning	就	京亠口小尤尢儿丿㇟丶
ri	里	日
navigate	航	舟亢亠几丿
box	箱	竹相木目
benefit	益	八皿
fascination	魅	鬼丿田儿㇟厶未木
milk	乳	孚⺤子了㇇亅一乙
borrow	借	亻昔龷日廾十丿
bullet	弾	弓単⺍甲日一丨
darkness	暗	日音立亠
boulder	岩	山石口
wrap	包	勹丿己
weak	弱	弓冫
persuade	勧	𠂉隹亻力
lovely	麗	一鹿广厂比匕
core	奥	丿冂米木大人
cherry tree	桜	木⺍女
daughter	娘	女良艮
dye	染	氵九乙木
mail	郵	垂千丿十土⻏
acid	酸	酉西一囗儿丿㇟夋允厶夂
godown	倉	人口
one-sided	片	
chop	析	木斤
contact	触	角𠂊虫中口丨
indications	徴	彳亻山王攵乂丿
self	己	
winter	冬	夂冫
wound	傷	亻𠂉昜旦日一勿勹
bureaucrat	官	宀冖口
candy	菓	艹果日木
dangerous	危	𠂊丿厄厂卩㔾
genuine	純	糸幺小屯丿屮凵
age	齢	歯止卜米木凵令𠆢一卩
drama	劇	豦虍丿七一豕刂
fluid	液	氵夜亠亻夕
leader	将	⺦⺤寸
dose	剤	斉文亠二一刂
defense	衛	行彳亻韋口
reliant	依	亻衣亠𧘇
healing	癒	疒愈兪入一月刂心
recollection	憶	忄意音立亠日心
graduate	卒	亠从人十
disaster	災	巛火人
undress	脱	月兌八兄口儿丿㇟
spine	呂	口丿
escape	逃	兆儿丿㇟冫⻌
river	河	氵可丁一口亅
footgear	履	尸復彳亻复𠂉日夂
leather	革	廿十口
suck	吸	口及丿又
seven	七	一乙
Dr.	博	十尃甫用丶寸
pledge	契	龶刀大人
sultry	暑	日者耂土
admonish	警	敬苟艹句勹丿口攵乂言
atmosphere	雰	雨分八刀
hair of the head	髪	髟長厶彡友又
bequeath	遺	貴中口丨貝目八⻌
cold	寒	宀冖三二一八冫
eternity	永	丶水
cow	牛	
wheel	輪	車日侖人一冊冂廾十丿
thorn	刺	朿木冂刂
play music	奏	𡗗三二一人天大
six	六	亠八
bottom	底	广厂氐氏一
quake	震	雨辰厂
demolition	壊	土十罒衣亠𧘇
needle	針	金全𠆢王十
publish	刊	干十刂
leap	躍	足口羽隹亻
tighten	締	糸幺小帝亠冖巾
instant	即	艮卩厶
brain	脳	月⺍凶乂丿凵
lack	欠	人
treasure	宝	宀冖玉王丶
deer	鹿	广厂比匕
flock	群	君尹⺕尸丿口羊⺷䒑
thick	厚	厂日子了㇇亅一
resign	辞	舌千口辛立亠十
dreadful	怖	忄布巾
soldier	兵	丘斤丿一八
flourish	栄	⺍冖木
wonder	驚	敬苟艹句勹丿口攵乂馬灬
tassel	房	戸方亠
tracks	跡	足口亦亠丿亅
window	窓	穴宀冖八厶心
expand	伸	亻申日丨
rise up	昇	日升丿廾十
congratulations	賀	加力口貝目八
beguile	惑	或戈弋口一丿丶心
pelt	皮	又
tail	尾	尸毛
salt	塩	土𠂉口皿
stratum	層	尸曽田日
engrave	刻	亥亠人刂
climate	候	亻丨矢天大人
slope	坂	土反厂又
center	央	丨大人
wall	壁	辟尸口辛立亠十土
exploits	績	糸幺小責龶貝目八
garment	衣	亠𧘇
floating	浮	氵孚⺤子了㇇亅一
nifty	凄	冫妻⺕女
jurisdiction	領	令𠆢一卩頁貝目八
hearing	審	宀冖番釆丿米木田
delicate	微	彳亻山兀一儿丿㇟攵乂
insect	虫	中口丨
dilute	薄	艹溥氵甫用丶寸
blow	吹	口欠人
feathers	羽	
exquisite	妙	女少小丿
previously	既	艮旡儿丿㇟八
coach	督	叔上卜一小又目
spicy	辛	立亠十
land	陸	⻖坴土儿丿㇟
sweat	汗	氵干十
green	緑	糸幺小彔⺕氺
skeleton	骨	月
blossom	咲	口关天大人
dew	露	雨路足口各夂
dry	干	十
timber-trees	樹	木吉士豆一口䒑寸
prudence	慮	虍七一思田心
packed	詰	言口吉士
column	欄	木闌門柬束日口
elder brother	兄	口儿丿㇟
level	均	土匀勹丿冫二一
easy	易	日勿勹
wicked	邪	牙亅丿⻏
shining	昭	日召刀口
embrace	抱	扌包勹丿己
infancy	幼	幺力
neighboring	隣	⻖粦米木舛夕
accustomed	慣	忄貫毋貝目八
conceal	隠	⻖⺤⺕心
olden times	旧	丨日
prolong	延	正丿止卜廴
foothold	拠	扌処夂几丿
eaves	宇	宀冖于二一亅
sham/provisional	仮	亻反厂又
the following	翌	羽立亠
sand	砂	石口少小丿
wink	瞬	目舜⺤冖舛夕
longevity	寿	三二一丿寸
ridicule	慢	忄曼日罒又
interrogative	那	二一⻏
pattern	範	竹車日卩㔾
mention	述	朮木丶⻌
cupfuls	杯	木不一丿丨
yellow	黄	龷由八
affix	貼	貝目八占卜口
cornerstone	礎	石口楚林木疋卜人
challenge	挑	扌兆儿丿㇟冫
sad	悲	非心
entice	誘	言口秀禾丿木乃
busy	忙	忄亡亠匸
fiber	維	糸幺小隹亻
part of speech	詞	言口司一
crime	犯	⺨㔾
dirty	汚	氵二一
orders	令	𠆢一マ㇇
ear	耳	
shoot	射	身寸
tome	冊	冂丨廾丿十
burdensome	駄	馬灬太大人丶
flour	粉	米木分八刀
confront	抗	扌亢亠几丿
run alongside	沿	氵㕣八口
loose	漫	氵曼日罒又
tailor	裁	𢦏土十戈弋衣亠𧘇丿丶
afflicted	患	串口中丨心
writing brush	筆	竹聿⺕丨
spare time	暇	日叚又
annexed	添	氵忝夭丿大人⺗
ought	須	彡頁貝目八
abolish	廃	广厂発癶二一儿丿㇟
spread	敷	旉甫用丶方亠攵乂丿
stop-over/parking	駐	馬灬主丶王
paint	塗	涂氵余𠆢小土
elder sister	姉	女市亠巾
hemp	麻	广厂林木
concentrated	濃	氵農曲日廾丿十辰厂
domesticate	飼	飠司一口
proclaim	宣	宀冖亘二一旦日
warmth	暖	日爰⺤友又
rapids	瀬	氵頼束木口頁貝目八
coloring	彩	采⺤木彡
eyeball	眼	目艮
printing	刷	尸丿巾刂
presents	贈	貝目八曽田日
shrink	縮	糸幺小宿宀冖佰亻百白日
negate	否	不一丿丨口
guilt	罪	罒非
winding	繰	糸幺小喿品口木
toil	努	奴女又力
evade	避	辟尸口辛立亠十⻌
step	踏	足口沓水日
angry	怒	奴女又心
various	諸	言口者耂土日
long-distance	距	足口巨匚二一
best regards	宜	宀冖且月一
burn	燃	火人然月犬大丶灬
grind	磨	麻广厂林木石口
salvation	救	求氺丶攵乂丿
tears	涙	氵戻戸大人
crimson	紅	糸幺小工
laid waste	荒	艹亡亠匸川
decameron	旬	勹丿日
riot	乱	舌千口乙
smoke	煙	火人垔覀土
cottage	舎	人吉士口
tense	緊	臣又糸幺小
watch over	看	手丿目
mistake	誤	言口呉八
outburst	暴	日㳟共龷八氺
benevolence	徳	彳亻十罒心
bundle	束	木口丿
drought	乾	𠦝十早日乞𠂉乙
decorate	飾	飠𠂉巾
wife	妻	⺕女
suspicious	怪	忄圣又土
bamboo	竹	
bed	床	广厂木
hole	穴	宀冖八
county	郡	君尹⺕尸丿口⻏
arm	腕	月宛宀冖夗夕卩㔾
armor	甲	日丨
hundred million	億	亻意音立亠日心
masculine	雄	厷丿厶隹亻
stinking	臭	自目大人
tree-trunk	幹	𠦝十早日人干
delicious	旨	匕日
delight	歓	𠂉隹亻欠人
savings	貯	貝目八宁宀冖丁一亅
discard	捨	扌舎人吉士口
bay	浦	氵甫用丶
comrade	輩	非車日
abundant	裕	衤谷𠆢口
fat	脂	月旨匕日
sweep	掃	扌帚⺕冖巾
boil	煮	者耂土日灬
climax	至	厶土
deceased	亡	亠匸
juvenile	童	立亠里日
welfare	祉	礻止卜
strange	奇	大人可丁一口亅
holy	聖	耳口王
chirp	鳴	口鳥灬
refreshing	涼	氵京亠口小
astringent	渋	氵止卜冫
vice-	副	畐一口田刂
lake	湖	氵胡古十口月
cosmetics	粧	米木庄广厂土
younger brother	弟	八弔弓丨丿
genius	才	扌亅
fasten	括	扌舌千口
shelf	棚	木朋月
pocket	懐	忄十罒衣亠𧘇
sabre/saber	剣	㑒人一口刂
beach	岸	山厂干十
penetrate	徹	彳亻育亠厶月攵乂丿
abuse	弊	敝小冂攵乂丿廾十
drive	駆	馬灬区匚乂丿
princess	姫	女臣
excel	秀	禾丿木乃
-proof	耐	而寸
consort	伴	亻半二一十
overpowering	豪	亠口冖豕
bosom	胸	月匈勹丿凶乂凵
suspend	懸	縣県目小系丿糸幺心
join	併	亻并干十
radiance	輝	光⺌兀一儿丿㇟軍冖車日
egg	卵	卯丶丿卩
curtain	幕	莫艹日大人巾
government office	庁	广厂丁一亅
guy	奴	女又
cloud	雲	雨云二一厶
repudiate	排	扌非
review	閲	門兌八兄口儿丿㇟
phrase	句	勹丿口
specimen	鑑	金全𠆢王監臣𠂉皿
nightbreak	旦	日一
affinity	縁	糸幺小彖彑⺕豕
catch	捕	扌甫用丶
rather	寧	寍宀冖心罒丁一亅
Sino-	漢	氵艹口夫大人
urge	迫	白日⻌
lagoon	潟	氵舄臼勹丿灬
religion	宗	宀冖示二一小
transparent	透	秀禾丿木乃⻌
hillock	塚	土冢冖豕
gulf	湾	氵弯亦亠丿亅弓
inflammation	炎	火人
home town	郷	乡艮⻏
consume	喫	口契龶刀大人
younger sister	妹	女未木
rot	腐	府广厂付亻寸肉冂人
sugar	糖	米木唐广厂⺕口
grip	握	扌屋尸至土
reparation	償	亻賞尚⺌冂口貝目八
aim at	狙	⺨且月一
look to	臨	臣𠂉品口
noodles	麺	麦龶夂面而
pot	鍋	金全𠆢王咼冂口
shoulder	肩	戸月
gigantic	巨	匚
seize	獲	⺨蒦艹隻隹亻又
destroy	滅	氵戌厂戈弋一火人丿丶
jump	踊	足口甬マ㇇用
hoist	揚	扌昜旦日一勿勹
nightfall	晩	日免𠂊儿丿㇟
defer	譲	言口㐮六亠八三二一𧘇
inscription	銘	金全𠆢王名夕口
tender	柔	矛予マ㇇了亅丿木
spirits	霊	雨二一
contraption	械	木戒戈弋廾十丿丶
loins	腰	月要覀女
lean	傾	亻頃匕頁貝目八
poem	詩	言口寺土寸
pinch	摘	扌啇亠冂古十口
pork	豚	月豕
mid-air	宙	宀冖由日丨
consign	託	言口乇丿七一
bear	熊	能厶月匕灬
offering	献	南䒑十冂干犬大人丶
hermit	仙	亻山
mirror	鏡	金全𠆢王竟立亠音日儿丿㇟
dart	矢	天大人
barley	麦	龶夂
Buddha	仏	亻厶
accusation	訴	言口斥斤丶
stimulate	促	亻足口龰
ghost	鬼	甶丿田儿㇟八厶
mysterious	玄	亠幺
crumble	崩	山朋月
stagnate	滞	氵帯丗卅廾廿十川丿冖巾
rare	珍	王人彡
nose	鼻	自目畀田廾十丿
withdraw	控	扌空穴宀冖八工
soup	汁	氵十
poison	毒	龶三二一毋
skids/shins	脚	月却去土厶卩
follow	随	陏⻖有月⻌
boisterous	騒	馬灬又虫中口丨
poverty	貧	分八刀貝目
exhort	奨	将⺦⺤寸大人
shallow	浅	氵戋三二一戈弋丿丶
mellow	熟	孰享亠口子了㇇亅一丸九乙丶灬
leak	漏	氵尸雨
cape	埼	土奇大人可丁一口亅
seal	封	圭土寸
shoes	靴	革廿十化亻匕
charcoal	炭	山灰厂火人
shade	陰	⻖今𠆢一云二厶
retainer	臣	
sincerity	誠	言口成𠂊丿戈弋丶
recommend	薦	艹广厂灬
purple	紫	此止卜匕糸幺小
instead	却	去土厶卩
tread	践	足口戋三二一戈弋丿丶
collide	衝	行彳亻重千丿十里
sparkle	晶	日
germ (wheat)	菌	艹囗禾丿木
slippery	滑	氵骨月
small bell	鈴	金全𠆢王令人一マ㇇
boy	坊	土方亠
patrol	巡	巛⻌
emperor	皇	白日王
pregnancy	妊	女壬丿士
repress	抑	扌卩
equal	匹	匸儿丿㇟八
second	秒	禾丿木少小
beckon	招	扌召刀口
hill	丘	斤丿一
look back	顧	雇戸隹亻頁貝目八
worship	拝	扌一丰三二丨
melt	溶	氵容宀冖谷𠆢口
masses	衆	血皿亻
branch off	岐	山支十又
board	搭	扌荅艹合𠆢一口
courage	勇	マ㇇男田力
damp	湿	氵日业
tenacious	執	幸土𢆉䒑干十丸九乙丶
frozen	凍	冫東木日
camp	陣	⻖車日
cramped	狭	⺨夹二一大人从
cram school	塾	孰享亠口子了㇇亅一丸九乙丶土
approve	賛	夫大人貝目八
stare	眺	目兆儿丿㇟冫
lamp	灯	火人丁一亅
pluck	抽	扌由日丨
Europe	欧	区匚乂丿欠人
shame	恥	耳心
send back	還	睘罒口𧘇⻌
swift	迅	卂乙十⻌
tortoise	亀	𠂊电日
so-and-so	某	甘廿十木
stirred up	奮	大人隹亻田
repent	悔	忄毎丿毋
pray	祈	礻斤
dragon	竜	立亠
alliance	盟	明日月皿
instruction	訓	言口川
banquet	宴	宀冖日女
netting	網	糸幺小罔罒冂亡亠匸
punish	刑	开干十刂
Mr.	殿	尸共龷八殳几丿又
farm	畑	火人田
brandish	揮	扌軍冖車日
vinegar	酢	酉西一囗儿丿㇟乍
drunk	酔	酉西一囗儿丿㇟卆九乙十
tide	潮	氵朝𠦝十早日月
frame	枠	木卆九乙十
deposit	預	予マ㇇了亅頁貝目八
awe	敬	苟艹句勹丿口攵乂
pickling	漬	氵責龶貝目八
intuition	勘	甚甘廿十匹匚儿丿㇟八力
employ	雇	戸隹亻
riddle	謎	言口迷米木辶
cedar	杉	木彡
marsh	沼	氵召刀口
rice plant	稲	禾丿木⺤旧丨日
humanity	仁	亻二一
immature	稚	禾丿木隹亻
turf	芝	艹之丶
icicle	氷	水丶
hunt	狩	⺨守宀冖寸
thread	糸	幺小
constitution	憲	宀冖罒心
luxuriant	繁	敏毎丿毋攵乂糸幺小
loneliness	寂	宀冖叔上卜一小又
bond	債	亻責龶貝目八
steal	盗	次冫欠人皿
exhaust	尽	尺尸八冫
chicken	鶏	奚⺤夫大人鳥灬
entrails	臓	月蔵艹厂戈弋臣丿丶
ancestor	祖	礻且月一
signature	署	罒者耂土日
criticism	批	扌比匕
cultivate	培	土咅立亠口
nucleus	核	木亥亠人
bury	埋	土里日
breed	牧	牛攵乂丿
sphere	圏	囗巻𠔉二一人己
sovereign	帝	亠冖巾
concurrently	兼	䒑八⺕丨
gauze	羅	罒維糸幺小隹亻
grains	粒	米木立亠
ditch	堀	土屈尸出山凵
likeness	如	女口
steam	蒸	艹烝丞了㇇亅水一灬
fertilizer	肥	月巴己
marry into	嫁	女家宀冖豕
risk	冒	日冂目
clean	浄	氵争𠂊⺕亅
pear tree	梨	利禾丿木刂
gracious	雅	牙亅丿隹亻
peach tree	桃	木兆儿丿㇟冫
lunatic	狂	⺨王
pair	双	又
revered	尊	酋八酉西一囗儿丿㇟寸
grains of sand	沙	氵少小丿
shove	挨	扌矣厶矢天大人
imminent	拶	扌巛夕
bough	枝	木支十又
preface	序	广厂予マ㇇了亅
falsehood	偽	亻為丶勹丿灬
soul	魂	云二一厶鬼丿田儿㇟
dig	掘	扌屈尸出山凵
boast	誇	言口夸大人二一
chafe	摩	麻广厂林木手
swing	揺	扌䍃⺤缶午山
register	簿	竹溥氵甫用丶寸
attack	襲	龍立亠月衣𧘇
phantasm	幻	幺
intelligent	賢	臣又貝目八
demand	需	雨而冂
laundry	濯	氵羽隹亻
eminent	卓	卜早日十
esteem	尚	⺌冂口
ceremony	儀	亻義羊⺷䒑我丿戈弋亅丶
parch	燥	火人喿品口木
plantation	栽	𢦏土十戈弋木丿丶
shout	叫	口丩丨
liver	肝	月干十
chant	唱	口昌日
clap	拍	扌白日
particularly	殊	歹一夕朱未木
fishing	漁	氵魚𠂊田灬
abandon	棄	亠厶丗卅廾廿十川丿木
rob	奪	大人隹亻寸
philosophy	哲	折扌斤口
sated	飽	飠包勹丿己
explanation	釈	釆丿米木尺尸八
sink	沈	氵冘冖儿丿㇟
stiff	硬	石口更日乂丿
buttocks	尻	尸九乙
hooch	酎	酉西一囗儿丿㇟寸
rod	棒	木奉𡗗三二一大人丨
char	焦	隹亻灬
waterfall	滝	氵竜立亠
solely	唯	口隹亻
swim	泳	氵永丶水
resist	抵	扌氐氏一
home country	邦	丰三二一丿⻏
pavilion	亭	亠口冖丁一亅
obese	肪	月方亠
pay respects	伺	亻司一口
submerge	潜	氵替夫大人日
encourage	励	厂丿万一力
crane	鶴	寉宀冖隹亻鳥灬
equestrian	騎	馬灬奇大人可丁一口亅
placenta	胞	月包勹丿己
willow	柳	木卯丿卩
flip	翻	番釆丿米木田羽
vertical	縦	糸幺小従彳亻疋龰卜人
Asia	亜	二一口
drowsy	睡	目垂千丿十土
interview	遇	禺日田禸厶冂⻌
tower	閣	門各夂口
villa	荘	艹壮⺦士
immersed	浸	氵⺕冖又
forge	鍛	金全𠆢王段殳几丿又
consent	諾	言口若艹右
encroach	侵	亻⺕冖又
journey	往	彳亻主丶王
yield	屈	尸出山凵
dish	皿	
ford	渉	氵歩止卜少小丿
haiku	俳	亻非
wholesale	卸	午干正十止卜卩
animal	獣	⺍田口犬大人丶
intimidate	威	戍厂戈弋一女丿丶
coin	銭	金全𠆢王戋三二一戈弋丿丶
rust-colored/cinnabar	丹	冂丿丶
item	箇	竹固囗古十口
chic	粋	米木卆九乙十
slender	繊	糸幺小土戈弋业丿丶
seduce	召	刀口
grasp	把	扌巴己
set aside	措	扌昔龷日廾十丿
revise	訂	言口丁一亅
artisan	匠	匚斤
consummate	遂	豕⻌
hedge	垣	土亘二一旦日
loyalty	忠	中口丨心
bracing	爽	大人爻乂
enlightenment	悟	忄吾五二一口
with child	娠	女辰厂
withstand	堪	土甚甘廿十匹匚儿丿㇟八
urine	尿	尸水
storm	嵐	山風几丿虫中口丨
rapidly	疾	疒矢天大人
tin can	缶	午山
key	鍵	金全𠆢王建聿⺕丨廴
split	裂	列歹一夕刂衣亠𧘇
spit	吐	口土
cruel	酷	酉西一囗儿丿㇟告牛口
thin	淡	氵炎火人
bud	芽	艹牙亅丿
hump	隆	⻖夂生
pierce	貫	毋貝目八
accidentally	偶	亻禺日田禸厶冂
yearn	憧	忄童立亠里日
axis	軸	車日由丨
moping	鬱	缶午山木冖鬯凵匕彡
lose weight	痩	疒叟申日丨又
Point	岳	丘斤丿一山
wet	潤	氵閏門王
pillar	柱	木主丶王
search	捜	扌叟申日丨又
measurement	寸	
livestock	畜	玄亠幺田
isolate	隔	⻖鬲一口冂儿丿㇟
interment	葬	艹死歹一夕匕廾十丿
partial	偏	亻扁戸冊冂廾十丿
recess	憩	舌千口息自目心
slacken	緩	糸幺小爰⺤友又
stomach	胃	田月
silence	黙	黒里日犬大人丶灬
bubbles	泡	氵包勹丿己
flats	軒	車日干十
armpit	脇	月劦力
cap	帽	巾冒日目
cook	炊	火人欠
ear (of a plant)	穂	禾丿木恵由日丨心
skin	膚	虍七一胃田月
intestines	腸	月昜旦日一勿勹
amass	蓄	艹畜玄亠幺田
pottery	陶	⻖勹丿缶午山
endure	忍	刃刀丶心
sleeve	袖	衤由日丨
repeatedly	頻	歩止卜少小丿頁貝目八
briar	茨	艹次冫欠人
musical score	譜	言口普並一业日
hegemony	覇	覀䩗革廿十月
magnet	磁	石口兹艹玄亠幺
tribute	貢	工貝目八
diagonal	斜	余𠆢小斗丶
cleverness	敏	毎丿毋攵乂
domburi	丼	井二一廾十丿丶
chain	鎖	金全𠆢王⺌貝目八
warship	艦	舟監臣𠂉皿
T'ang	唐	广厂⺕口
vicarious	摂	扌耳冫
cotton	綿	糸幺小帛白日巾
fermentation	酵	酉西一囗儿丿㇟孝耂土子了㇇亅
thunder	雷	雨田
chair	椅	木奇大人可丁一口亅
jubilation	慶	广厂心夂
grave	墓	莫艹日大人土
basin	盆	分八刀皿
pick up	拾	扌合𠆢一口
pitch dark	闇	門音立亠日
soft	軟	車日欠人
Big Dipper	斗	丶
deviate/elude	逸	免𠂊儿丿㇟⻌
overgrown	茂	艹戊丿厂戈弋丶
grandchild	孫	子了㇇亅一系丿糸幺小
inquire	尋	⺕工口寸
expose	披	扌皮又
however	但	亻旦日一
fishguts	乙	
vein	脈	月𠂢丿亻
nest	巣	⺍丶果日木
slap	撲	扌菐业三二一人
wing	翼	羽異田共龷八
face-up	仰	亻卬卩
humility	慎	忄真十具目八
pathetic	哀	衣亠𧘇口
vat	槽	木曹曲日廾丿十
prostrated	伏	亻犬大人丶
membrane	膜	月莫艹日大人
sagacious	俊	亻夋允厶儿丿㇟夂
lass	嬢	女㐮六亠八三二一𧘇
sticky	粘	米木占卜口
strict	堅	臣又土
tiger	虎	虍七一儿丿㇟
pagoda	塔	土荅艹合𠆢一口
pearl	珠	王朱未木
chrysanthemum	菊	艹勹丿米木
repay	酬	酉西一囗儿丿㇟州丶川
sword	刀	
purification	斎	斉文亠乂示二一小
summit	峰	山夆夂丰三二一丨
clear (the land)	拓	扌石口
bowl	鉢	金全𠆢王本木
repel	拒	扌巨匚二一
vulgar	俗	亻谷𠆢口
inferiority	劣	少小丿力
colleague	僚	亻大人日小
wandering	浪	氵良艮
give up	諦	言口帝亠冖巾
undefiled	潔	氵絜刀糸幺小
admirable	偉	亻韋口
augment	殖	歹一夕直十目
harvest	穫	禾丿木蒦艹隻隹亻又
distract	紛	糸幺小分八刀
melancholy	憂	百一日冖心夂
foolish	愚	禺日田禸厶冂心
more and more	弥	弓尓丿小
how many	幾	幺戍戈弋厂人一丿丶
melodious	朗	良艮月
ardent	烈	列歹一夕刂灬
tatami mat	畳	田冖且月一
auspicious	祥	礻羊⺷䒑
drown	没	氵殳几丿又
prison	獄	⺨言口犬大人丶
potato	芋	艹于二一亅
spy	偵	亻貞卜貝目八
national flag	旗	方亠𠂉其甘廿十八
apprehend	逮	隶⺕氺⻌
large hill	阜	𠂤丿十
ridgepole	棟	木東日
stupid	痴	疒知矢天大人口
mediator	媒	女某甘廿十木
bewitched	妖	女夭丿大人
fierce	猛	⺨孟子了㇇亅一皿
destitution	乏	丿之丶
gun	銃	金全𠆢王充亠允厶儿丿㇟八
aroma	匂	勹丿匕
drift	漂	氵票覀示二一小
delusion	妄	亡亠匸女
umbrella	傘	人从十
sturdy	剛	岡冂䒑丨山刂
filial piety	孝	耂十子了㇇亅一
congeal	凝	冫疑匕矢天大人マ㇇疋卜
disclose	啓	戸攵乂丿口
tumor	腫	月重千丿十里
cloudy weather	曇	日雲雨云二一厶
mochi	餅	⻞𠆢并干十
swell	膨	月彭吉士豆一口䒑彡
descendants	昆	日比匕
carve	彫	周冂吉士口彡
seedling	苗	艹田
defile	潰	氵貴中口丨貝目八
sheep	羊	⺷䒑
encounter	遭	曹曲日廾丿十⻌
diameter	径	彳亻圣又土
collapse	陥	⻖𠂊旧丨日
frolic	戯	虚虍七一业戈弋丿丶
den	洞	氵同冂一口
perfume	芳	艹方亠
void	虚	虍七一业
overcome	克	古十兄口儿丿㇟
pony	駒	馬灬句勹丿口
front door	扉	戸非
remove	撤	扌育亠厶月攵乂丿
constancy	恒	忄亘二一旦日
epidemic	疫	疒殳几丿又
nourishing	滋	氵兹艹玄亠幺
claw	爪	丿
erect	架	加力口木
chop off	斬	車日斤
sickle	鎌	金全𠆢王兼䒑八⺕丨
fist	拳	二一人手
fog	霧	雨務矛予マ㇇了亅丿攵乂力
bases	塁	田冫土
capsize	覆	覀復彳亻复𠂉日夂
orphan	孤	子了㇇亅一瓜丿厶
mud	泥	氵尼尸匕
tongue	舌	千口
excellent	佳	亻圭土
shish kebab	串	口中丨
shellfish	貝	目八
droop	垂	千丿十土
corner	隅	⻖禺日田禸厶冂
cleanse	汰	氵太大人丶
pillow	枕	木冘冖儿丿㇟
bright jewels	璧	辟尸口辛立亠十玉王丶
penalty	罰	罒言口刂
insert	挿	扌千丿十日
cylinder	筒	竹同冂一口
adjusted	斉	文亠乂二一
praise	褒	衣亠𧘇保亻呆口木
rectify	矯	矢天大人喬呑夭丿口冂
seethe	沸	氵弗弓丿丨
coarse	粗	米木且月一
gradually	徐	彳亻余𠆢小
drum	鼓	吉士豆一口䒑支十又
affixed	附	⻖付亻寸
address	宛	宀冖夗夕卩㔾
horizon	涯	氵厓厂圭土
ethics	倫	亻侖人一冊冂廾十丿
limb	肢	月支十又
mannerism	癖	疒辟尸口辛立亠十
hawser	綱	糸幺小岡冂䒑山
kudzu	葛	艹曷日匂勹丿人
horse chestnut	栃	木厂万一
sew	縫	糸幺小逢夆夂丰三二一丨⻌
tolerant	寛	宀冖莧艹見目儿丿㇟
pointed	鋭	金全𠆢王兌八兄口儿丿㇟
calm	穏	禾丿木⺤⺕心
pity	惜	忄昔龷日廾十丿
pupil	瞳	目童立亠里日
pleasure	愉	忄兪入一月刂
crown	冠	冖元二一儿丿㇟寸
rub	抹	扌末木
wipe	拭	扌式弋工丶
steel	鋼	金全𠆢王岡冂䒑山
two-mat area	坪	土平干十
obscure	昧	日未木
commandment	戒	戈弋廾十丿丶
grace	恩	因囗大人心
pop song	唄	口貝目八
reap	刈	乂丿刂
flower pot	瓶	并干十瓦丶
threaten	脅	劦力月
family crest	紋	糸幺小文亠乂
training	稽	禾丿木尤尢儿㇟丶旨匕日
portent	兆	儿丿㇟冫
bubble up	湧	氵勇マ㇇男田力
tyrannize	虐	虍七一
wretched	惨	忄参厶大人彡
brew	醸	酉西一囗儿丿㇟㐮六亠八三二𧘇
accept humbly	戴	𢦏十戈弋異田共龷八丿丶
sequential	循	彳亻盾厂十目
consolation	慰	尉尸示二一小寸心
deceit	欺	其甘廿十八欠人
ashes	灰	厂火人
cauldron	釜	父金全𠆢王
cannon	砲	石口包勹丿己
departed	逝	折扌斤⻌
permanence/remote	悠	攸亻丨攵乂丿心
subjugate	征	彳亻正止卜
hearth	炉	火人戸
kick	蹴	足口就京亠小尤尢儿丿㇟丶
token	符	竹付亻寸
assault	殴	区匚乂丿殳几又
deluge	洪	氵共龷八
lie	詐	言口乍丿
desk	机	木几丿
erupt	噴	口賁卉十廾丿貝目八
disconcerted	慌	忄荒艹亡亠匸川
naked	裸	衤果日木
reputation	誉	⺍八言口
bystander	傍	亻旁立亠冖方
podium	壇	土亶亠回囗口旦日一
feed	餌	⻞𠆢耳
nab	捉	扌足口龰
fan	扇	戸羽
surname	姓	女生
curse	呪	口兄儿丿㇟
rut	軌	車日九乙
knee	膝	月木氺
vague	漠	氵莫艹日大人
mineral	鉱	金全𠆢王広广厂厶
robust	壮	⺦士
patent	彰	章立亠早日十彡
outskirts	郊	交亠父⻏
mediocre	凡	几丿丶
bowstring	弦	弓玄亠幺
lucidity	澄	氵登癶豆一口䒑
trade	貿	卯卩刀丿貝目八
toy	玩	王元二一儿丿㇟
bow	弓	
wither	枯	木古十口
confused	錯	金全𠆢王昔龷日廾十丿
rotation	旋	方亠𠂉疋卜人
chess piece	棋	木其甘廿十八
shield	盾	厂丿十目
chink	隙	⻖小日
peaceful	泰	𡗗三二一大人氺
appear	顕	显日业頁貝目八
snake	蛇	虫中口丨它宀冖匕
calendar	暦	厂林木日
greatness	傑	亻桀舛夕木
hide	匿	匸若艹右口
mountain stream	渓	氵奚⺤夫大人
conspire	謀	言口某甘廿十木
sandwiched	挟	扌夹二一大人从
brocade	錦	金全𠆢王帛白日巾
observance/dedicate	奉	𡗗三二一大人丿丨
throat	喉	口侯亻矢天大人
burglar	賊	貝目八戎戈弋十丿丶
clod	塊	土鬼丿田儿㇟厶
harp	琴	王今𠆢一
temporarily	暫	斬車日斤
concave	凹	凵
hop	跳	足口兆儿丿㇟冫
sweet oak	椎	木隹亻
sue	訟	言口公八厶
exhibit/line up	陳	⻖東木日
chief	伯	亻白日
Noh chanting	謡	言口䍃⺤缶午山
conveyor	搬	扌般舟殳几丿又
lead (metal)	鉛	金全𠆢王㕣八口
mountain peak	峠	山上卜一下
envious	羨	羊⺷䒑氵欠人
lid	蓋	艹盍去土厶皿
till	耕	耒丿未木井二一廾十
blade	刃	刀丿丶
monkey	猿	⺨袁土衣亠𧘇口
gall bladder	胆	月旦日一
formerly	曽	八田日
gutter	溝	氵冓三二一再冉冂土
block up	塞	宀冖三二一八土
pardon	赦	赤亦土攵乂丿
beautiful woman	媛	女爰⺤友又
vow	誓	折扌斤言口
compensation	賠	貝目八咅立亠口
Buddhist priest	僧	亻曽田日
surplus	剰	乗千丿十木刂
arrest	拘	扌句勹丿口
lungs	肺	月市亠巾
trifle	僅	亻艹三二一
capital suburbs	畿	幺戈弋田丿丶
residence	邸	氐氏一⻏
husk	殻	壳士冖几丿殳又
gentle	妥	⺤女
rainbow	虹	虫中口丨工
sociable	懇	豸艮心
drip	滴	氵啇亠冂古十口
grate	擦	扌察宀冖祭月示二一小
cereals	穀	士冖禾丿木殳几又
inflation	騰	月駦龹二一人馬灬
adroit	巧	工丂
crude	朴	木卜
copper	銅	金全𠆢王同冂一口
stalk	茎	艹圣又土
penal	懲	徴彳亻山王攵乂丿心
thwart	阻	⻖且月一
indigo	藍	艹監臣𠂉皿
display	呈	口王
upright	貞	卜貝目八
corridor	廊	广厂郎良艮⻏
provisions	糧	米木量旦日一里
countenance	貌	豸皃白日儿丿㇟八
boat	舟	
tranquilize	鎮	金全𠆢王真十具目八
versify	吟	口今𠆢一
dormitory	寮	宀冖尞大人日小
sulphur	硫	石口㐬亠厶川
mulberry	桑	又木
decline	衰	衣亠𧘇口
daring	敢	耳攵乂丿
horizontal	緯	糸幺小韋口
hate	憎	忄曽田日
superfluous	冗	冖几丿
lot	壌	土㐮六亠八三二一𧘇
chopsticks	箸	竹者耂土日
honey	蜜	宓宀冖必心丿虫中口丨
crush	拉	扌立亠
neglect	怠	台厶口心
sacrifice	犠	牛義羊⺷䒑我丿戈弋亅丶
dike	堤	土是日疋龰卜人
cadet	曹	曲日廾丿十
bee	蜂	虫中口丨夆夂丰三二一
truss	縛	糸幺小尃甫用丶寸
alienate	疎	疋卜人束木口
zero	零	雨令𠆢一マ㇇
roast	煎	前八月刂灬
smash	砕	石口卆九乙十
flute	笛	竹由
clan	藩	艹潘氵番釆丿米木田
animal sacrifice	牲	牛生
squad	班	王刂
tempering	錬	金全𠆢王東木日
black ink	墨	黒里日灬土
thigh	股	月殳几丿又
decrease	耗	耒丿未木毛
dining tray	膳	月善羊⺷䒑口
persimmon	柿	木市亠巾
girder	桁	木行彳亻
relatives	戚	戊厂戈弋尗上卜一小丿丶
lightning-bug	蛍	⺍冖虫中口丨
commoner	庶	广厂廿十灬
glossy	艶	豊曲日廾十丿豆一口䒑色𠂊巴己
self-effacing	謙	言口兼䒑八⺕丨
leisure	閑	門木
gland	腺	月泉白日水
Zen	禅	礻単⺍甲日一丨
Go	碁	其甘廿十八石口
cavity	孔	子了㇇亅一乙
disturb	妨	女方亠
halberd	矛	予マ㇇了亅丿
hem	裾	衤居尸古十口
sail	帆	巾凡几丿丶
rowboat	艇	舟廷壬丿士廴
set	据	扌居尸古十口
regularity	秩	禾丿木失夫大人
wick	芯	艹心
fragrant	薫	艹重千丿十里灬
kidney	腎	臣又月
dull	鈍	金全𠆢王屯丿屮凵
old woman	婆	波氵皮又女
seclude/faint	幽	山丨幺
shaku	尺	尸八
vermilion	朱	丿未木
aid	扶	扌夫大人
navy blue	紺	糸幺小甘廿十
mimic	擬	扌疑匕矢天大人マ㇇疋卜
give	呉	口八
intercept	遮	庶广厂廿十灬⻌
lock	錠	金全𠆢王定宀冖疋龰卜人
lips	唇	辰厂口
mosquito	蚊	虫中口丨文亠乂
basket	籠	竹龍立亠月
miss	喪	十丨口衣亠𧘇
sigh	嘆	口艹夫大人
swelling	瘍	疒昜旦日一勿勹
villain	凶	乂丿凵
sprain	挫	扌坐从人土
gamble	賭	貝目八者耂土日
manipulate	掌	尚⺌冂口手
gorge	峡	山夹二一大人从
marrow	髄	骨月有⻌
unlucky	厄	厂卩㔾
everywhere	遍	扁戸冊冂廾十丿⻌
yell	喚	口奐𠂊冂儿丿㇟大人
performing artist	伎	亻支十又
eyebrow	眉	丿目
hug	擁	扌雍亠乡隹亻
respect	恭	共龷八⺗
towel	巾	
voiced	濁	氵蜀罒勹丿虫中口丨
sire	紳	糸幺小申日丨
kiln	窯	穴宀冖八羔羊⺷䒑灬
plug	栓	木全𠆢王人
womb	胎	月台厶口
bell	鐘	金全𠆢王童立亠里日
lacquer	漆	氵桼木氺
tile	瓦	丶
ecstasy	悦	忄兌八兄口儿丿㇟
tombstone	碑	石口卑丿田十
fell	伐	亻戈弋丿丶
recitation	詠	言口永丶水
blind	盲	亡亠匸目
goodwill	款	士示二一小欠人
mercy	慈	兹艹玄亠八幺心
courts	廷	壬丿士廴
seaweed	藻	艹澡氵喿品口木
cavern	窟	穴宀冖八屈尸出山凵
ooze	泌	氵必心丿
silk	絹	糸幺小肙口月
regret/resentment	恨	忄艮
waiter	侍	亻寺土寸
trunk	胴	月同冂一口
superintend	宰	宀冖辛立亠十
Hades	冥	冖日六亠八
tinker with	弄	王廾十丿
rebuke	諭	言口兪入一月刂
proceed	赴	走土龰卜
convex	凸	㇐凵丨
transition	遷	覀大人己⻌
paddy-ridge	畔	田半二一十
headland	岬	山甲日丨
grant	賜	貝目八易日勿勹
foot of a mountain	麓	林木鹿广厂比匕
equivocal	曖	日愛⺤冖心夂
pan	汎	氵凡几丿丶
tremendously	甚	甘廿十丨匹匚儿丿㇟八
adore	崇	山宗宀冖示二一小
captured	囚	囗人
recreation	娯	女呉口八
lowly	卑	丿田十
mourning	忌	己心
I (one)	壱	士冖匕
mausoleum	陵	⻖夌土儿丿㇟夂
bungling	拙	扌出山凵
elucidate	詮	言口全𠆢王人
watchtower	楼	木娄米女
mortar	臼	
enclosure	郭	享亠口子了㇇亅一⻏
uncle	叔	上卜一小又
hungry	飢	飠几丿
immediate	頓	屯丿屮凵頁貝目八
spiny	梗	木更日乂丿
whirlpool	渦	氵咼冂口
daybreak	暁	日尭卉十廾丿兀一儿㇟
bluffs	崖	山厂圭土
scar	痕	疒艮
equilibrium	衡	行彳亻𩵋𠂊田大人
control	轄	車日害宀冖龶口
accumulate	累	田糸幺小
jealous	妬	女石口
nun	尼	尸匕
chin	顎	咢口二一頁貝目八
distress	愁	秋禾丿木火人心
awakening	醒	酉西一囗儿丿㇟星日生
wee hours	宵	宀冖肖⺌月
marine blue	瑠	王留卯卩丿田
squeeze	搾	扌窄穴宀冖八乍丿
tusk	牙	亅丿
game-hunting	猟	⺨鼡⺍用
moreover	且	月一
speckled	斑	王文亠乂
degenerate	堕	陏⻖有月土
resemblance	肖	⺌月
diarrhea	痢	疒利禾丿木刂
baron	爵	⺤罒艮寸
come apart at the seams	綻	糸幺小定宀冖疋龰卜人
crystal	璃	王离亠凶乂丿凵禸厶冂
tomb	墳	土賁卉十廾丿貝目八
collar	襟	衤禁林木示二一小
fuel/firewood	薪	艹新立亠木斤
visit a shrine	詣	言口旨匕日
starve	餓	飠我丿戈弋亅丶
rhyme	韻	音立亠日員口貝目八
tempt	唆	口夋允厶儿丿㇟夂
agreement	肯	止卜月
queen	妃	女己
liner	舶	舟白日
cash	幣	敝小冂攵乂丿巾
spinning	紡	糸幺小方亠
plug up	窒	穴宀冖八至厶土
anxiety	煩	火人頁貝目八
thirst	渇	氵曷日匂勹丿人匕
elbow	肘	月寸
hard up	窮	穴宀冖八躬身弓
hoarse	喝	口曷日匂勹丿人匕
decay	朽	木丂
embarrass	辱	辰厂寸
solemn	粛	聿⺕丨米木
fervent	篤	竹馬灬
slave	隷	士示二一小隶⺕氺
abide by	遵	尊酋八酉西一囗儿丿㇟寸⻌
crash	墜	隊⻖豕土
obvious	瞭	目大人日小
effulgent	旺	日王
stationary	箋	竹戔戈弋丿丶
meritorious deed	勲	動重千丿十里力灬
envy	嫉	女疾疒矢天大人
drowning	溺	氵弱弓冫
piled high	堆	土隹亻
whale	鯨	魚𠂊田灬京亠口小
captive	虜	虍七一男田力
wrenching	捻	扌念今𠆢一心
frost	霜	雨相木目
intimate	睦	目土儿丿㇟
darning	繕	糸幺小善羊⺷䒑口
extract	抄	扌少小丿
rue	慨	忄既艮旡儿丿㇟八
heir	嗣	口冊冂十廾丿司一
spinal column	脊	人二一月
remains	骸	骨月亥亠人
discreet	謹	言口𦰌艹三二一
bag	俵	亻表二一衣亠𧘇
vapor	汽	氵气𠂉
bargain	廉	广厂兼䒑八⺕丨
II	弐	一弋二丶
scorn	侮	亻毎丿毋
ugly	醜	酉西一囗儿丿㇟鬼田厶
numb	萎	艹委禾丿木女
beg	乞	𠂉乙
feminine	雌	此止卜匕隹亻
bullying	苛	艹可丁一口亅
divide	剖	咅立亠口刂
make headway	捗	扌歩止卜少小丿
quasi-	准	冫隹亻
aroused	憤	忄賁卉十廾丿貝目八
lament	悼	忄卓卜早日十
insult	罵	罒馬灬
nitrate	硝	石口肖⺌月
erection	勃	孛十冖子了㇇亅一力
sniff	嗅	口臭自目犬大人丶
bustle	奔	大人卉十廾丿
palisade	柵	木冊冂廾丿十
barbarian	蛮	亦亠丿亅虫中口丨
consult with	諮	言口咨次冫欠人
stipend	俸	亻奉𡗗三二一大人丨
windpipe	咽	口因囗大人
hinge	枢	木区匚乂丿
confer	叙	余𠆢小又
go upstream	遡	朔屰屮凵丿月辶
casting	鋳	金全𠆢王寿三二一丿寸
receive	享	亠口子了㇇亅一
empress	后	厂丿口
kidnap	拐	扌口刀
flexed	勾	勹丿厶
pursue	逐	豕⻌
grudge	怨	夗夕卩心㔾
military officer	尉	尸丿示二一小寸
reef	礁	石口焦隹亻灬
fine	緻	糸幺小致至厶土攵乂丿
furthermore/waver	猶	⺨酋八酉西一囗儿丿㇟
clique	閥	門伐亻戈弋丿丶
nursing	哺	口甫用丶
scaffold	桟	木戋三二一戈弋丿丶
metallurgy	冶	冫台厶口
bartending	酌	酉西一囗儿丿㇟勺勹丶
dread	惧	忄具目八
overflow	濫	氵監臣𠂉皿
fence	塀	土屏尸并干十
pining	慕	莫艹日大人⺗
seriousness	摯	執幸土𢆉䒑干十丸九乙丶手
V.I.P.	賓	宀冖少小丿貝目八
condolences	弔	弓丨
cowardice	臆	月意音立亠日心
highness	陛	⻖比匕土
glossary	彙	彑冖果日木
moment	刹	乂丿木刂
levy	賦	貝目八武一弋止卜丶
saliva	唾	口垂千丿十土
vessels	隻	隹亻又
grab	采	⺤木
graceful	淑	氵叔上卜一小又
venerable old man	翁	公八厶羽
tariff	租	禾丿木且月一
brown	褐	衤曷日匂勹丿人匕
partition	頒	分八刀頁貝目
measuring box	升	丿廾十
arc	弧	弓瓜丿厶
partner	侶	亻呂口丿
bribe	賄	貝目八有月
lazy	惰	忄左工月
matrimony	姻	女因囗大人
revile	蔑	艹罒戍戌厂戈弋一丿丶
entrust	嘱	口属尸禹丿虫禸厶冂
cover over	蔽	艹敝小冂攵乂丿
emulate	倣	亻放方亠攵乂丿
commonplace/comfortable	庸	广厂⺕用
footprint	踪	足口宗宀冖示二一小
coffin	棺	木官宀冖口
be proud	傲	亻敖土放方亠攵乂丿
lewd	淫	氵⺤壬丿士
widow	寡	宀冖自目分八刀
break	毀	臼土殳几丿又
modest	遜	孫子了㇇亅一系丿糸幺小辶
pit	坑	土亢亠几丿
steadily	漸	氵斬車日斤
covet	貪	今𠆢一貝目八
dairy products	酪	酉西一囗儿丿㇟各夂口
metaphor	喩	口兪入一月刂
stealth	窃	穴宀冖八切七一刀
torture	拷	扌考耂土丿
marquis	侯	亻矢天大人
silkworm	蚕	天一大人虫中口丨
menacing/upbraid	嚇	口赫赤亦土
twist	糾	糸幺小丩丨
bridegroom	婿	女胥疋卜人月
mimeograph/facsimile	謄	朕月二一大人言口
remorse	憾	忄感咸戍厂戈弋一口丿丶心
barracks	屯	丿屮凵乙
imperial order	勅	束木口力
commander	帥	丿巾丨
widespread	氾	氵卩㔾
obituary	訃	言口卜
martyrdom	殉	歹一夕旬勹丿日
derision	嘲	口朝𠦝十早日月
cocoon	繭	艹冂糸幺小虫中口丨
apprehensive	畏	田一
officer	吏	丈一口乂丿
calamity	禍	礻咼冂口
Confucian	儒	亻需雨而冂
harsh	辣	辛立亠十束木口
furrow	畝	亠田久𠂊丿
transfer/alternate	迭	失丿夫大人⻌
model	塑	朔屰屮凵丿月土
tremble	慄	忄栗覀木
axe	斤	
inmost	衷	衣亠𧘇口丨
gunwale	舷	舟玄亠幺
rin	厘	厂里日
self-indulgent	恣	次冫欠人心
third class	丙	一内冂人
reject	斥	斤丿丶
obeisance/auxiliary	陪	⻖咅立亠口
legitimate wife	嫡	女啇亠冂古十口
groundbreaking	墾	豸艮土
parcel post	逓	乕厂丿二一巾⻌
ashamed	羞	羊⺷䒑丿丑一
imperial edict	詔	言口召刀
quit	罷	罒能厶月匕
frugal	倹	亻㑒人一口
irrigate	沃	氵夭丿大人
pox	痘	疒豆一口䒑
mutual affection	諧	言口皆比匕白日
graft	賂	貝目八各夂口
uneasiness	虞	虍七一呉口八
yearning	憬	忄景日京亠口小
square style	楷	木皆比匕白日
audience	謁	言口曷日匂勹丿人匕
censure	劾	亥亠人力
majestic plural	朕	月天大人
imperial seal	璽	爾一八冂爻乂玉王丶
confinement	錮	金全𠆢王固囗古十口
peel	剝	彑氺刂
cheek	頰	夾大人从頁貝目八
make good	塡	土眞匕具目八
scold	𠮟	口七